 XXXXXX  XXXXXX
  X XX XXXXXX X
X  X XXX   XXXX
  XX X XXX XXXX
X     XX XXXX X
XX  XXX XXXX XX
XX     DXXXXXXX